1 9
XXXXXXXXXXXXXXXXXXXX
XXXXX     C    XXXXX
X F X XX XX XX X F X
X X X          X X X
X X   X XXXX X   X X
X XX XX XXXX XX XX X
X                  X
X XXX XX XX XX XXX X
X XX  XX PV XX  XX X
X XX XXX XXBXXX XX X
X XX XXX XX XXX XX X
X XX  XX    XX  XX X
X XXX XX XX XX XXX X
X                  X
X XX XX XXXX XX XX X
X X   X XXXX X   X X
X X X          X X X
X   X XX XX XX X   X
XXXXX    F     XXXXX
XXXXXXXXXXXXXXXXXXXX