9 15
XXXXXXXXXXXXXXXXXXXX
X     XX    XX    FX
X XXX    XX    XXX X
X XX  X XXXX X  XX X
X XX XX      XX XX X
X     XX XX XX     X
X X X    Y     X X X
XFX XX XXXXXX XX X X
X X      PV      X X
X X XXX XXXX XXX X X
X XFXXX XXXX XXX X X
X X         F    X X
X X XX XXXXXX XX X X
X X X          X X X
X     XX XX XX     X
X XX XX      XX XX X
X XX  X XXXX X  XX X
XCXXX    XX    XXXBX
X     XX    XX     X
XXXXXXXXXXXXXXXXXXXX