9 18
XXXXXXXXXXXXXXXXXXXX
X               C  X
X XXXX XXXXXX XXXX X
X X       Y      X X
X X XXXX XX XXXX X X
X X XX   XX   XX X X
X   XX X PV X XX   X
X X XX X XX X XX X X
X   FX X XX X XX   X
X X XX X XX X XX X X
X X XX X XX X XX X X
X   XX X XX X XF   X
X X XX X XX X XX X X
X   XX X    X XX   X
X X XX   XX   XX X X
X X XXXX XX XXXX X X
X X              X X
X XXXX XXXXXX XXXX X
X  S               X
XXXXXXXXXXXXXXXXXXXX