3 9
XXXXXXXXXXXXXXXXXXXX
X F                X
X XX X XXXXXX X XXSX
X X  X  XXXX  X  X X
X X XXX  PV  XXX X X
X       XXXX       X
X X XXX      XXX X X
X X XXX XXXX XXX XFX
X       XXXX       X
X X XXX XXXX XXX X X
X X XXX XXXX XXX X X
X       XXXX       X
X X XXX XXXX XXX X X
X X XXX      XXX X X
X       XXXX       X
X X XXX  C   XXX X X
X X  X  XXXX  X  X X
X XX X XXXXXX XFXX X
X                  X
XXXXXXXXXXXXXXXXXXXX