5 15
XXXXXXXXXXXXXXXXXXXX
X       XXXX  S    X
X X XXX      XXX X X
X X XFX XXXX XFX X X
X X     XXXX     X X
X   XX XXXXXX XX   X
X X      PV      X X
X X XXXX XX XXXX X X
X        XX        X
X X X X XXXX X X X X
X X X X XXXX X X X X
X        XX        X
X X XXXX XX XXXX X X
X X              X X
X   XX XXXXXX XX   X
X X     XXXX     X X
X X X X XXXX X X X X
X X XXX      XXX X X
X       XXXX      BX
XXXXXXXXXXXXXXXXXXXX