9 16
XXXXXXXXXXXXXXXXXXXX
X                  X
X XX X X XX X X XX X
X XX   X    X  SXX X
X XXX XXXXXXXX XXX X
XF                FX
X XX X X XX X X XX X
X XX X X XX X X XX X
X B  X   YR   X    X
X XX X X XX X X XX X
X XX X X XX X X XX X
X    X   PV   X    X
X XX X X XX X X XX X
X XX X X XX X X XX X
XF                FX
X XXX XXXXXXXX XXX X
X XX   X    X   XX X
X XX X X XX X X XX X
X             C    X
XXXXXXXXXXXXXXXXXXXX