9 17
XXXXXXXXXXXXXXXXXXXX
X        XX        X
X XX X X    X X XX X
X X  X XXXXXX X  X X
X   XX   YR   XX F X
X X    X XX X    X X
X XX X X PV X X XX X
X    X   XX   X  C X
X X XX XXXXXX XX X X
X XSX     X    X X X
X X X XXX   XX X X X
X X X  XXXXXX  X X X
X    X   XX   X  B X
X XX X X    X X XX X
X X    X XX X    X X
X F XX        XX   X
X X  X XXXXXX X  X X
X XX X X    X X XX X
X        XX        X
XXXXXXXXXXXXXXXXXXXX